0101010000
0100010110
0101010100
0001000101
1111111101
1100001000
1101111010
0000000010
1111101110
0000000000
